111111111111111111111111111111
100100000000000000000000000001
10P0000000000000000000C0000001
111100000000000000000000000001
10000C000000000000000000000001
100000000000000000000000000001
100000000000000000000000000001
100000000000000C00000000000001
100000000000000000000000000001
1000000C0000000000000000000E01
100000000000000000000000000001
111111111111111111111111111111
