1111111111111
100111000T001
100000E0000P1
1P0C010000001
1111111111111
