1111111111111
1001000000000
1000010000001
1P0C010000001
1111111111111
