11111111111
1EC0C000001
10P00000001
11111111111
