11111111111111111111111111
1P011111111111111111111E11
11011111111111111111111011
11000100010001000010100011
11011101110101011110101011
11000000000000000000000011
11110101110011011010101011
11000100010101000010100011
11011111111111111111110111
1C011111111111111111110C11
11111111111111111111111111
